R   1500 100
NO ./textures/barrel.xpm
S  ./textures/mario.xpm
WE ./textures/mossy.xpm 
EA ./textures/colorstone.xpm
SO  ./textures/unsplash_wall_texture.xpm
F 3, 115, 0
C 179, 223, 242                 

1111111111111111111111111111
111100000000000000000000001111
1000000000000000000000000011
11111000000000000000000000011
1000000022222222220000000011
1000000011111111111000000001
1111111011111111111111111111
1000000011111111111000000001
1000000011111111111000000001
1000000011111111111000000001
100000000000000000000N0001111
1000000000000000000000000001   
10000000000000000000000002111
111111111111111111111111111